ۗ	tuai	  ؕ 
ۙ 	takhalus	  ؔ 
ۛ	three dots above	 ۛ 
ۜ	high seen	 ۜ 
ﵐ	jeem	  ۚ
ﶈ	lam_alef	  ۙ 
ﵧ	tuai	  ؕ 
ﵗ	jeem+salay	  ۚۖ 
ﴰ	meem+tuai+takhalus	 ۘؕؔ 
ﴱ	meem+sakta+ftNote	 ۘࣝ࣠ 
ﴲ	qaf+jeem+salay	 ࣗۚۖ 
ﴳ	jeem+ftNote	 ۚ࣠ 
ﴴ	takhalus+meem+tuai	 ؔۘؕ 
ﴵ	meem+safha	 ۘ࣡ 
ﵐ	jeem	  ۚ 
ﵑ	jeem+3dots	 ۚۛ 
ﵒ	jeem+zai	 ۚؗ 
ﵓ	jeem+suad	 ۚࣕ 
ﵔ	jeem+tuai	 ۚؕ 
ﵕ	jeem+qaaf		 ۚࣗ 
ﵖ	jeem+lam_alef	 ۚۙ 
ﵗ	jeem+salay	 ۚۖ 
ﵘ	jeem+qaf	 ۚࣞ 
ﵙ	jeem+takhalus	 ۚؔ 
ﵚ	jeem+qaaf+salay	 ۚࣗۖ 
ﵛ	jeem+salay+3dots	 ۚۖۛ 
ﵜ	jeem+tuai+takhallus	 ۚؕؔ 
ﵝ	jeem+3dots+takhallus	 ۚۛؔ 
ﵞ	jeem+qaf+3dots	ۚࣞۛ
ﵟ	zai	 ؗ 
ﵠ	zai+salay	 ؗۖ
ﵡ	zai+qaf+salay	 ؗࣗۖ
ﵢ	zai+qaaf	 ؗࣗ
ﵣ	suad	 ࣕ
---------------------------- Replaced till here
ﵤ	suad+salay	 ࣕۖ 
ﵥ	suad+lam_alef	 ࣕۙ 
ﵦ	suad+qaf	 ࣕࣞ 
ﵧ	tuai	  ؕ 
ﵨ	tuai+3dots	ؕۛ
ﵩ	tuai+sakta		 ؕࣝ 
ﵪ	tuai+qaf	 ؕࣞ 
ﵫ	tuai+takhallus	 ؕؔ 
ﵬ	tuai+qaf+lam_alef	 ؕࣗۙ 
ﵭ	tuai+meem+takhallus	 ؕۘؔ 
ﵮ	tuai+jeem	 ؕۚ 
ﵯ	qaaf	ࣗ
ﵰ	qaaf+zai	ࣗؗ
ﵱ	qaaf+lam+alef	ࣗۙ
ﵲ	qaaf+salae	ࣗۖ
ﵳ	qaaf+zai+salay	ࣗؗۖ
ﵴ	qaf	ࣞ
ﵵ	qaf+three dots	ࣞۛ
ﵶ	qaf+tuai	ࣞؕ
ﵷ	qaf+lam+alef	ࣞۙ
ﵸ	qaf+takhalus	ࣞؔ
ﵹ	qaf+jeem+three dots	ࣞۚۛ
ﵺ	qaf+three dots+takhalus	ࣞۛؔ
ﵻ	qaaf+jeem 	ࣗۚ
ﵼ	five+jeem	࣢ۚ
ﵽ	five+zai	࣢ؗ
ﵾ	five+tuai	࣢ؕ
ﵿ	five+laam+alef	࣢ۙ
ﶀ	five+qaf	࣢ࣞ
ﶁ	five+jeem+salay	࣢ۚۖ
ﶂ	five+tuai+three dots	࣢ؕۛ
ﶃ	five+laam+alef+suad	࣢ۙࣕ
ﶄ	five+jeem+salay+three dots	࣢ۚۖۛ
ﶅ	five+qaf+jeem+three dots	࣢ࣞۚۛ
ﶆ	five+laam+alef+jeem 	࣢ۙۚ
ﶇ	five+jeem+qaf+three dots	࣢ۚࣞۛ
ﶈ	laam+alef	ۙ
ﶉ	meem	ۘ
ﶊ	meem+takhalus	ۘؔ
ﶋ	waqfa	ࣟ
ﶌ	sakta	ࣝ
ﶍ	three dots+jeem+salay	ۛۚۖ
ﶎ	three dots+jeem	ۛۚ
ﶒ	ain	ࣖ
ﶓ	takhalus	ؔ
ﶔ	jeem	ۚ
ﶕ	jeem+three dots	ۚۛ
ﶖ	jeem+laam+alef	ۚۙ
ﶗ	jeem+salay	ۚۖ
ﶘ	jeem+salay+three dots	ۚۖۛ
ﶙ	jeem+aim+three dots	ۚࣖۛ
ﶚ	zai	ؗ
ﶛ	zai+salay	ؗۖ
ﶜ	zai+laam+alef	ؗۙ
ﶝ	suad	ࣕ
ﶞ	suad+salay	ࣕۖ
ﶟ	suad+laam+alef	ࣕۙ
ﶠ	tuai	ؕ
ﶡ	tuai+three dots	ؕۛ
ﶢ	tuai+ain	ؕࣖ
ﶣ	tuai+takhalus	ؕؔ
ﶤ	qaaf	ࣗ
ﶥ	qaaf+laam+alef	ࣗۙ
ﶦ	qaaf+salay	ࣗۖ
ﶧ	qaaf+salay+three dots	ࣗۖۛ
ﶨ	qaf	ࣞ
ﶩ	qaf+jeem	ࣞۚ
ﶪ	qaf+laam+alef	ࣞۙ
ﶫ	laam+alef	ۙ
ﶬ	laam+alef+three dots	ۙۛ
ﶭ	meem	ۘ
ﶮ	meem+takhalus	ۘؔ
ﶯ	salay	ۖ
ﶰ	salay+laam+alef	ۖۙ
ﶱ	three dots+tuai	ۛؕ
ﶲ	three dots+laam+alef	ۛۙ
ﶳ	jeem+salay+laam+alef	ۚۖۙ
ﶴ	jeem+laam+alef+three dots	ۚۙۛ
ﶵ	jaam+salay+three dots+laam+alef	ۚۖۛۙ
ﶶ	sajdah+ain	ࣛࣖ
ﶷ	sajdah	ࣛ
ﶸ	salasa+jeem+ain	ࣚۚࣖ
ﶹ	salasa	ࣚ
ﶺ	arba	ࣔ
ﶻ	safha	࣡
ﶼ	salay+jeem	ۖۚ
ﶽ	tuai+sakta 	ؕࣝ
ﶾ	qaaf+salay+laam+alef	ࣗۖۙ
ﶿ	laam+alef+qaaf+salay	ۙࣗۖ
ﷀ	tuai+jeem	ؕۚ
ﷁ	three dots+jeem	ۛۚ
ﷂ	sajda+tuai 	ࣛؕ
ﷃ	waqfa	ࣟ
ﷄ	laam+alef+qaaf	ۙࣗ
ﷅ	jeem+laam+alef+salay	ۚۙۖ
ﷆ	laam+alef+salay+jeem	ۙۖۚ
ﷇ	laam+alef+salay	ۙۖ
ﷰ	ain+tuai	ࣖؕ
ﷱ	laam+alef+suad	ۙࣕ
ﷲ	laam+alef+jeem	ۙۚ
ﷳ	sajda+jeem	ࣛۚ
ﷴ	zai+salay	ؗۖ
ﷵ	jeem+salay	ۚۖ